########
###    #
#    # #
# ## # #
# A# #B#
########